##################
#  ##         ##a#
## #  ## #### ## #
## # ##  ####    #
## # ## ######## #
## # ##        # #
## ########### # #
##       b     # #
## ############# #
#  ##            #
##################